1111111
100E001
1000001
1C0C0C1
1000001
1C0P0C1
1111111
