111111111111111
110000000000001
100000000000001
10000P00C000001
1000000000C0001
1E000000C000001
111111111111111
